111111111
10P0000E1
100000CE1
111111111