11111111111111111
1P0000000EC000001
11111111111111111