111111111111111111
1P000C0000000001E1
111111111111111111