111111111
1P0000001
100C00001
111111111