111111111
10E000111
10C001P11
111111111