1111111111111111111111111
1C001000001000100000000E1
1110001110000110111111111
1110111011110000100000C11
1000000001001111001100001
1011111011000111001101111
10000C10000001110011010C1
1111111110011111001101011
1P00000000000000000000001
1111111111111111111111111
