111111111
10P000111
10E001C11
111111111