111111111
10P000111
10C001E11
111111111