111111111
100000001
100000CE1
111111111